10 12 1
@@@@@@@@@@@@
W..@.@@@..@@
@@.@@.@@@.@@
...@..@...@@
..@..@..@..@
@.@.@.@.@.@.
...@...@...@
@....@...@..
@.@.@...@..@
@@@@@@@...$@